1111111111111
10000000C0001
100P000000001
1C000C00E1001
1111111111001
